==========
=#########
=#X      #
=# #     #
=#C  #####
=#  C   X#
=# C     #
=# XE    #
=#########
==========

