=######===
##  X ####
#   T    #
#  XCO   #
#        #
# &  P   #
#    B   #
#    U   #
# TC    E#
##########
