==========
=######===
=#    #===
=# CCX###=
=### E  #=  
===#    #=
===#X  ##=
===#####== 
==========
==========