##########
#E   #   #
#    #   #
#    #   #
# &  #####
#   U    #
#  U  C  #
 ###     #
   #  X  #
##########
