#######===
#     ####
#XCO PP  #
#%###O##O#
#      # #  
#B     # #
#    #   #
#  L#    # 
#E M#    #
##########