==========
=#####====
## E ####=
#  #    ##
# #      #
# CC X#  #
##    ####
=##X  #=== 
==#####===
==========