##########
#E   #X  #
#    # C #
#    # T #
# &  #####
#   U    #
#  #  C  #
=###     #
===#    T#
##########
