##########
#E   #X B#
#    # C #
#    # T #
# &  #####
#   U    #
## U     #
=###     #
===#    T#
===#######
